%%%%%%%
% P   %
% %%% %
% %   %
% %%% %
%.    %
%%%%%%%