%%%%%%%
% P   %
% %%% %
% %.  %
% %%% %
%     %
%%%%%%%